11111111111111
1P000C000100E1
10P00000000001
11111111111111