1111111111111111111111111
1E00000000000000000000001
1000010000010000010000101
1100010001P10001000100001
1000000000000000000000001
1000000000000000C000000E1
1111111111111111111111111















