11111111111111
10000C000000E1
10P00000000001
11111111111111